SO file.xpm
SE file2.xpm
NO file3.xpm
NE file1.xpm
C 0,254, 255
F 0,0, 255

11111111111111
10000000000001
10000000000001
10000000000001
100000E0000001
10000000000001
10000000000000
10000000000001
10000000000000
11111111111111