SO textures/xpms/creme.xpm
SE textures/xpms/lapiNyxeS_0.xpm
NO textures/xpms/lapiNyxeS_1.xpm
NE textures/xpms/marc.xpm

C 0,254, 255
F 255,0, 255

11111111111111
10000000000001
10000000001111
10000000111111
10000000000001
1000N010000001
10000001000001
10000000000001
10000000000001
10000000000001
10000000000001
11111111111111