NO ./textures/xterm-linux.xpm
SO ./textures/xterm-linux.xpm
WE ./textures/xterm-linux.xpm
EA ./textures/xterm-linux.xpm
F 255,0,255
C 128,255,0


  11    1111111111111111111111111
  11    10000000001100000000001
  11    10110000011100000000001  1
        100100000000000000000011
111111111011000001110000000000001
100000000011000001110111111111111
11110111111111011100000010001
11110111111111011101010010001
11000000110101011100000010000  1
10000000000000001100000010001 1
10000000000000001101010010001
11000001110101011111011110N0111
11110111 1110101 101111010001
11111111 1111111 111111111111