NO ./textures/xpms/lapiNyxeS_0.xpm
SO ./textures/xpms/creme.xpm
EA ./textures/xpms/lapiNyxeS_1.xpm
WE  ./textures/xpms/marc.xpm

F 0,0,0
C 0,0,0

111111111111
111000100011
111000000011
1110000N0011
111000000011
111000000011
111000000001
11000000001
111100000001
111111111111