NO ./textures/xpms/lapiNyxeS_0.xpm
SO ./textures/xpms/creme.xpm
EA ./textures/xpms/lapiNyxeS_1.xpm
WE  ./textures/xpms/marc.xpm

F 0,0,0
C 0,0,0

1111111111111
1110111111111
1110000001111
1110000N00001
1111110001111
1111111  1111

1111111111111
11100000001111
11110000000111
1111111111111
 