NO ./textures/w3d/trees.xpm
SO ./textures/w3d/trees_1.xpm
WE ./textures/w3d/trees_2.xpm
EA ./textures/w3d/trees_3.xpm
C 0,  0   , 0
F 81, 60, 28


        111111111111111111111111
        1000000000110000000000001
        1011000001110000000000001
        1001000000000000000000001
111111111011000001110000000000001
100000000011000001110111110111111
11110111111111011100000010001
11110111111111011101010010001
11000000110101011100000010001
10000000000000001100000010001
10000000000000001101010010001111111
11000001110101011111011110E00000001
11110111 1110101 101111010001111111
11111111 1111111 111111111111